SOOOHHHHHHHHHHHHHHHOOOO
OOOOOIIIHOOIOOHIIIOOOOO
OOOOOIIIIOHHHOIIIIOOOOO
OOOOOIHIIOOIOOIIHIOOOOO
OOOOOOOOOOOIOOOOOOOOOOO
OOOOOIHIIOOIOOIIHIOOOOO
OOOOOIIIIOHHHOIIIIOOOOO
OOOOOIIIHOOIOOHIIIOOOOO
OOOOHHHHHHHHHHHHHHHOOOG